
NO ./textures/spooky-nighttime.png
SO ./textures/spooky-nighttime.png
WE ./textures/spooky-nighttime.png
EA ./textures/spooky-nighttime.png

F 0,0,20
C 0,0,10


1111111111111111111111111
1000000000000000000000001
1000000000000000000001001
100000000000000000000001
1000000000000000000000001
100000000000000000000000111
1000000000000000000000000001
1000000000000W0000000000111
1000000000000000000000001
1000000000000000000000001
1000000000000000000000001
1000000000000000000000001
1000000000000000000000001
1111111111111111111111111
