
NO ./textures/planks.png
EA ./textures/wall.png
WE ./textures/stonewall1.png
SO ./textures/stonewall.png

F 128,128,128
C 137,207,240

        1111111111111111111111111
        1000000000000000000000001
        101100001110000000000S001
        1001000000010000000000001
111111111011000001110000000000001
100000000011000001110111111111111
11110111111111011100000010000001    
11110111111111011101010010001111 
110000001101010111000000100000001
10000000000000000000000010001111
10000000000000011010100100001
110000011110101011111011110001
11110111 1110101 101111010001
11111111 1111111 111111111111





