
NO ./textures/planks.png
SO ./textures/stonewall.png
WE ./textures/stonewall1.png
EA ./textures/wall.png

F 0,0,255
C 0,128,0

        1111111111111111111111111
        1000000000110000000000001
        1011000001110000000000001
        100100000001000000S000001
111111111011000001110000000000001
100000000011000001110111111111111
11110111111111011100000010001    
11110111111111011101010010001111 
110000001101010111000000100000001
100000000000000011000000100011111
100000000000000011010100100001
11000001110101011111011110001
11110111 1110101 101111010001
11111111 1111111 111111111111
