
NO ./textures/planks.png


SO ./textures/stonewall.png
F 128,128,128


WE ./textures/stonewall1.png


EA ./textures/wall.png

C 137,207,240



        1111111111111111111111111
        10000000001100000000000E1
        101100001110000000000001
        100100000001000000000001
111111111011000001110000000000001
100000000011000001110111111111111
11110111111111011100000010001    
11110111111111011101010010001111 
110000001101010111000000100000001
10000000000000001100000010001111
10000000000000011010100100001
110000011110101011111011110001
11110111 1110101 101111010001
11111111 1111111 111111111111




                     


