
NO ./textures/planks.png
SO ./textures/stonewall.png
WE ./textures/stonewall1.png
EA ./textures/wall.png

F 220,100,0
C 225,30,0

1111111111111111111111111
1000000000000000000000001
1000000000000000000001001
1000000000000W00000000001
1000000000000000000000001
100000000000000000000000111
1000000000000000000000000001
100000000000000000000000111
1000000000000000000000001
1000000000000000000000001
1000000000000000000000001
1000000000000000000000001
1000000000000000000000001
1111111111111111111111111




