
NO ./textures/planks.png
SO ./textures/stonewall.png
WE ./textures/stonewall1.png
EA ./textures/wall.png

F 220,100,0
C 225,30,0

     11111  
    100S001
     10001
      101
       1




