NO ./textures/p2.png
EA ./textures/wall.png
WE ./textures/p1.png
SO ./textures/stonewall.png

F 50,0,50
C 255,140,0

1111111111111111111111111
1000000000000000000000001
1000111111111111111000001
100000000000W000001000001
1000000000000000001000001
1000111111111111111000001
1000100000000000001000001
1000000000000000001000001
1000111111111111111000001
1000000001000010000000001
1000000001000010000000001
1000000001000010000000001
1000000001000010000000001
1111111111    11111111111